1 1 1 _ _ _ _ _ _ _ _ _ _ B X X X B _ _ _ _ _ _ _ _ _ 4 4 4
1 1 1 X X _ _ _ _ _ _ X X X X S X X X X _ _ _ _ _ X X 4 4 4
1 1 X X _ _ _ _ X X X X 5 5 5 5 5 5 5 X X X X _ _ _ X X 4 4
_ X X _ _ _ X X X _ X 5 5 5 5 5 5 5 5 5 X _ X X X _ _ X X _
_ X _ _ _ _ _ _ _ _ X 5 5 5 5 5 5 5 5 5 X _ _ _ _ _ _ _ X _
_ _ _ X _ _ _ _ _ _ X _ _ _ _ X _ _ _ _ X _ _ _ _ _ _ _ _ _
_ _ _ X _ _ _ _ _ _ X _ _ _ _ X _ _ _ _ X _ _ _ _ _ X _ _ _
_ _ X X _ _ _ _ A _ X _ _ _ _ X _ _ _ _ X _ A _ _ _ X X _ _
_ _ X _ _ _ _ _ _ _ _ _ _ _ _ X _ _ _ _ _ _ _ _ _ _ _ X _ _
_ _ X X X X X X _ _ _ _ _ _ _ X _ _ _ _ _ _ X X X X X X _ _
_ X X 5 5 _ _ _ _ _ _ _ _ _ _ X _ _ _ _ _ _ _ _ _ 5 5 X X _
_ X 5 5 5 _ _ _ _ _ _ _ _ _ _ X _ _ _ _ _ _ _ _ _ 5 5 5 X _
B X 5 5 5 _ _ _ _ _ _ _ _ _ _ X _ _ _ _ _ _ _ _ _ 5 5 5 X B
X X 5 5 5 _ _ _ _ _ _ _ _ _ G X G _ _ _ _ _ _ _ _ 5 5 5 X X
X R 5 5 5 X X X X X X X X X X X X X X X X X X X X 5 5 5 R X
X X 5 5 5 _ _ _ _ _ _ _ _ _ G X G _ _ _ _ _ _ _ _ 5 5 5 X X
B X 5 5 5 _ _ _ _ _ _ _ _ _ _ X _ _ _ _ _ _ _ _ _ 5 5 5 X B
_ X 5 5 5 _ _ _ _ _ _ _ _ _ _ X _ _ _ _ _ _ _ _ _ 5 5 5 X _
_ X X 5 5 _ _ _ _ _ _ _ _ _ _ X _ _ _ _ _ _ _ _ _ 5 5 X X _
_ _ X X X X X X X _ _ _ _ _ _ X _ _ _ _ _ _ X X X X X X _ _
_ _ X _ _ _ _ _ _ _ _ _ _ _ _ X _ _ _ _ _ _ _ _ _ _ _ X _ _
_ _ X X _ _ _ _ A _ X _ _ _ _ X _ _ _ _ X _ A _ _ _ X X _ _
_ _ _ X _ _ _ _ _ _ X _ _ _ _ X _ _ _ _ X _ _ _ _ _ X _ _ _
_ _ _ X _ _ _ _ _ _ X _ _ _ _ X _ _ _ _ X _ _ _ _ _ X _ _ _
_ _ _ _ _ _ _ _ _ _ X _ _ _ _ X _ _ _ _ X _ _ _ _ _ _ _ _ _
_ X _ _ _ _ _ _ _ _ X 5 5 5 5 5 5 5 5 5 X _ _ _ _ _ _ _ X _
_ X X _ _ _ X X X _ X 5 5 5 5 5 5 5 5 5 X _ X X X _ _ X X _
3 3 X X _ _ _ _ X X X X 5 5 5 5 5 5 5 X X X X _ _ _ X X 2 2
3 3 3 X X _ _ _ _ _ _ X X X X S X X X X _ _ _ _ _ X X 2 2 2
3 3 3 _ _ _ _ _ _ _ _ _ _ B X X X B _ _ _ _ _ _ _ _ _ 2 2 2