_ _ _ X S _ _ _ _ _ _ _ _ _ _ _ _ _ _ _ _ _ _ _ _ _ _ _ _ _
_ L _ X X X X X X X X X X X _ _ X X X X X X X X X X _ _ O _
_ _ _ _ _ _ A X _ _ _ _ G X _ _ X G _ _ _ _ X _ _ _ _ _ _ _
_ _ _ _ _ _ _ X _ X _ _ X X _ _ X X _ _ X _ X _ _ _ _ _ _ _
_ X _ _ _ _ _ _ _ X B X X _ _ _ _ X X B X _ _ _ _ _ _ _ X X
_ X _ _ _ 1 1 1 1 X X X _ _ _ _ _ _ X X X 4 4 4 4 _ _ _ X S
_ X _ _ _ 1 1 1 1 X X _ _ _ _ _ _ _ _ X X 4 4 4 4 _ _ A X _
_ X X X _ 1 1 + X X _ _ _ _ _ _ _ _ _ _ X X + 4 4 _ X X X _
_ X _ _ _ 1 1 X X _ _ _ _ _ _ _ _ _ _ _ _ X X 4 4 _ _ _ X _
_ X _ X X X X X _ _ _ _ _ _ _ R _ _ _ _ _ _ X X X X X _ X _
_ X _ _ B X X _ _ X _ X X X X X X X X X _ _ _ X X B _ _ X _
_ X _ _ X X _ _ _ X _ X _ _ _ + _ _ _ _ _ _ _ _ X X _ _ X _
_ X G X X _ _ _ _ X _ X _ X X X X X X X _ _ _ _ _ X X G X _
_ X X X _ _ _ _ _ X _ X _ X _ _ _ _ _ X _ _ _ _ _ _ X X X _
_ _ _ _ _ _ _ _ R X _ X _ X _ X X X _ X _ _ _ _ _ _ _ _ _ _
_ _ _ _ _ _ _ _ _ X _ X _ _ F _ _ X _ X R _ _ _ _ _ _ _ _ _
_ X X X _ _ _ _ _ X _ X X X _ X _ X _ X _ _ _ _ _ _ X X X _
_ X G X X _ _ _ _ X _ _ _ _ _ X _ X _ X _ _ _ _ _ X X G X _
_ X _ X X X _ _ _ X X X X X X X _ X _ X _ _ _ _ X X _ _ X _
_ X _ _ X X _ _ _ _ _ _ _ + _ _ _ X _ X _ _ _ X X B _ _ X _
_ X _ _ B X X _ _ X X X X X X X X X _ X _ _ X X X X X _ X _
_ X _ X X X X X _ _ _ _ _ _ R _ _ _ _ _ _ X X 2 2 _ _ _ X _
_ X _ _ _ 3 3 X X _ _ _ _ _ _ _ _ _ _ _ X X + 2 2 _ X X X _
_ X X X _ 3 3 + X X X _ _ _ _ _ _ _ _ X X 2 2 2 2 _ _ _ X _
S X A _ _ 3 3 3 3 X X X _ _ _ _ _ _ X X X 2 2 2 2 _ _ _ X _
X X _ _ _ _ _ _ _ X B X X _ _ _ _ X X B X _ _ _ _ _ _ _ X _
_ _ _ _ _ _ _ X _ X _ _ X X _ _ X X _ _ X _ X _ _ _ _ _ _ _
_ _ _ _ _ _ _ X _ _ _ _ G X _ _ X G _ _ _ _ X A _ _ _ _ _ _
_ N _ _ X X X X X X X X X X _ _ X X X X X X X X X X _ _ M _
_ _ _ _ _ _ _ _ _ _ _ _ _ _ _ _ _ _ _ _ _ _ _ _ S X _ _ _ _