_ _ B _ _ _ _ _ _ _ _ _ _ _ _ _ _ _ _ _ _ _ _ _ _ _ _ _ _ _
_ _ _ _ _ _ _ _ _ _ _ + _ _ Q _ _ _ _ _ _ _ _ _ _ _ _ _ _ _
1 _ L _ _ _ _ X X X X X X X X X X X X X _ _ _ _ _ _ _ _ _ 2
_ _ _ _ _ _ _ _ _ X X X X X X X X X X _ _ _ _ _ _ _ _ _ _ _
_ _ _ _ _ _ _ _ _ _ _ _ _ _ _ _ _ _ _ _ _ _ _ _ _ _ _ _ _ _
_ _ X _ _ _ _ _ _ _ _ _ _ _ _ _ _ _ _ _ _ _ _ _ _ _ _ _ _ _
_ _ X _ _ X X X X X X X X X X X X X X X X _ _ _ _ + _ _ B _
_ _ X _ _ _ _ _ 0 0 0 0 0 0 0 _ _ _ _ R X _ _ _ _ _ _ _ _ _
_ _ _ _ _ X _ _ 0 0 0 0 0 0 0 _ _ _ _ _ X _ _ _ _ _ _ _ _ _
_ _ _ _ _ X H _ 0 0 0 0 0 0 0 _ _ _ _ _ X _ _ _ _ _ _ _ _ _
1 _ _ _ _ X X X X X X X X X _ _ _ X X X X _ _ _ _ _ _ _ _ 2
_ _ _ _ _ _ _ _ _ _ _ _ _ _ _ _ _ _ _ _ _ _ 0 0 _ _ _ _ _ _
_ _ _ 0 0 _ _ _ _ _ _ _ _ _ _ _ F _ _ _ _ _ 0 0 _ _ _ _ _ _
_ _ _ 0 0 _ _ _ X X X X X _ _ _ _ _ _ _ _ _ 0 0 _ _ _ _ _ _
_ C D 0 0 _ _ _ X A _ _ _ _ _ _ _ _ _ _ X _ 0 0 _ _ _ _ _ _
_ _ _ 0 0 _ _ _ X _ _ _ I _ _ _ _ _ _ E X _ 0 0 _ _ _ _ _ _
_ _ _ 0 0 _ _ _ _ _ _ _ _ _ _ _ _ _ _ _ X _ 0 0 _ _ _ _ _ _
_ _ _ 0 0 _ X X X X X X X X X X _ _ _ _ X _ 0 0 _ _ _ _ _ _
_ _ _ 0 0 _ _ _ _ + _ _ _ R _ _ _ _ _ _ X _ _ _ _ _ _ _ _ _
1 _ _ _ _ _ X X X X X X X _ _ _ _ _ _ _ _ _ _ _ _ _ _ _ _ 2
_ _ _ _ _ _ _ 0 0 0 0 0 0 0 X _ _ _ _ _ _ _ X X _ X _ _ _ _
_ _ _ _ _ _ _ 0 0 0 0 0 0 0 X _ _ _ _ _ _ X X _ _ _ _ _ _ _
_ _ _ _ _ _ _ X X X X X X X X _ _ _ _ _ _ X G _ X _ _ _ _ _
_ _ _ _ _ _ _ _ G X X X X X _ _ _ _ _ _ _ X _ _ _ _ _ _ _ _
_ _ _ _ _ _ _ _ _ _ _ _ _ _ _ _ _ _ _ _ _ _ _ X _ _ _ _ _ _
_ _ X _ _ _ _ _ _ _ _ _ _ _ _ 0 0 0 0 0 0 0 0 _ _ _ _ _ B _
_ _ X _ _ X X X X X X X X X _ 0 0 0 0 0 0 0 0 _ _ _ _ _ _ _
_ _ X _ _ _ _ _ _ _ _ _ S X _ 0 0 0 0 0 0 0 0 _ _ _ _ _ _ _
1 _ _ _ _ X _ _ _ _ _ _ _ X _ 0 0 0 0 0 0 0 0 _ _ _ M _ _ 2
_ _ B _ _ X _ + _ _ _ _ _ _ _ _ _ _ _ _ _ _ _ _ _ _ _ _ _ _