_ _ _ _ _ _ _ _ _ _ _ _ _ _ _ _ _ _ _ _ _ _ _ _ _ _ _ _ 1 1
_ _ _ X X X X X X X X X X X X X X X X X X X X X X X X X 1 1
_ _ X _ _ _ _ _ _ _ _ _ _ _ _ _ _ _ _ _ _ _ _ _ _ _ _ _ 1 1
_ _ X _ _ X X X X X X X X X X X X X X X X X X X X X X _ 1 1
_ _ X _ X _ _ _ _ _ _ _ _ _ _ _ _ _ _ _ _ _ _ _ _ _ _ X _ _
_ _ X _ X _ _ X X X X X X X X X X X X X X X X X X _ _ X _ _
_ _ X _ X _ X _ _ _ _ _ _ _ _ _ _ _ _ _ _ _ _ _ _ X _ X _ _
_ _ X _ X _ X _ X X X X X X X X X X X X X X X X _ X _ X _ _
_ _ X _ X _ X _ X _ _ _ _ _ _ _ _ _ _ _ _ _ _ X _ X _ X _ _
_ _ X _ X _ X _ X _ X X X X X X X X X X X X _ X _ X _ X _ _
_ _ X _ X _ X _ X _ X _ _ _ _ _ _ _ _ _ _ X _ X _ X _ X _ _
_ _ X _ X _ X _ X _ X _ X X X X X X X X _ X _ X _ X _ X _ _
_ _ X _ X _ X _ X _ X _ _ _ _ _ _ _ _ X _ X _ X _ X _ X _ _
_ _ X _ X _ X _ X _ X _ _ _ _ _ _ _ _ X _ X _ X _ X _ X _ _
_ _ X _ X _ X _ X _ X _ _ _ R S _ _ _ X _ X _ X _ X _ X _ _
_ _ X _ X _ X _ X _ X _ _ _ S R _ _ _ X _ X _ X _ X _ X _ _
_ _ X _ X _ X _ X _ X _ _ _ _ _ _ _ _ X _ X _ X _ X _ X _ _
_ _ X _ X _ X _ X _ X _ _ _ _ _ _ _ _ X _ X _ X _ X _ X _ _
_ _ X _ X _ X _ X _ X X X X X X X X _ X _ X _ X _ X _ X _ _
_ _ X _ X _ X _ X _ _ _ _ _ _ _ _ _ _ X _ X _ X _ X _ X _ _
_ _ X _ X _ X _ X X X X X X X X X X X X _ X _ X _ X _ X _ _
_ _ X _ X _ X _ _ _ _ _ _ _ _ _ _ _ _ _ _ X _ X _ X _ X _ _
_ _ X _ X _ X X X X X X X X X X X X X X X X _ X _ X _ X _ _
_ _ X _ X _ _ _ _ _ _ _ _ _ _ _ _ _ _ _ _ _ _ X _ X _ X _ _
_ _ X _ _ X X X X X X X X X X X X X X X X X X _ _ X _ X _ _
_ _ X _ _ _ _ _ _ _ _ _ _ _ _ _ _ _ _ _ _ _ _ _ _ X _ X _ _
2 2 X X X X X X X X X X X X X X X X X X X X X X X _ _ X _ _
2 2 _ _ _ _ _ _ _ _ _ _ _ _ _ _ _ _ _ _ _ _ _ _ _ _ _ X _ _
2 2 X X X X X X X X X X X X X X X X X X X X X X X X X _ _ _
2 2 _ _ _ _ _ _ _ _ _ _ _ _ _ _ _ _ _ _ _ _ _ _ _ _ _ _ _ _