0 0 0 0 _ _ _ _ _ _ _ _ _ _ _ _ _ _ _ _ _ _ _ _ _ _ _ _ 1 1
0 0 0 X X X X X X X X X X X X X X X X X X X X X X X X X 1 1
0 0 X _ _ _ _ _ _ _ _ _ _ _ _ _ _ _ _ _ _ _ _ _ _ _ _ _ 1 1
_ _ X _ _ X X X X X X X X X X X X X X X X X X X X X X _ 1 1
_ _ X _ X _ _ _ _ _ _ _ _ _ _ _ _ _ _ _ _ _ _ _ _ _ _ X _ _
_ _ X _ X _ _ X X X X X X X X X X X X X X X X X X _ _ X _ _
_ _ X _ X _ X _ _ _ _ _ _ _ _ _ _ _ _ _ _ _ _ _ _ X _ X _ _
_ _ X _ X _ X _ X X X X X X X X X X X X X X X X _ X _ X _ _
_ _ X _ X _ X _ X _ _ _ _ _ _ _ _ _ _ _ _ _ _ X _ X _ X _ _
_ _ X _ X _ X _ X _ X X X X X X X X X X X X _ X _ X _ X _ _
_ _ X _ X _ X _ X _ X _ _ _ _ _ _ _ _ _ _ X _ X _ X _ X _ _
_ _ X _ X _ X _ X _ X _ X X X X X X X X _ X _ X _ X _ X _ _
_ _ X _ X _ X _ X _ X 0 0 0 0 0 0 0 0 X _ X _ X _ X _ X _ _
_ _ X _ X _ X _ X _ X 0 0 0 0 0 0 0 0 X _ X _ X _ X _ X _ _
_ _ X _ X _ X _ X _ X 0 0 0 R S 0 0 0 X _ X _ X _ X _ X _ _
_ _ X _ X _ X _ X _ X 0 0 0 S R 0 0 0 X _ X _ X _ X _ X _ _
_ _ X _ X _ X _ X _ X 0 0 0 0 0 0 0 0 X _ X _ X _ X _ X _ _
_ _ X _ X _ X _ X _ X 0 0 0 0 0 0 0 0 X _ X _ X _ X _ X _ _
_ _ X _ X _ X _ X _ X X X X X X X X _ X _ X _ X _ X _ X _ _
_ _ X _ X _ X _ X _ _ _ _ _ _ _ _ _ _ X _ X _ X _ X _ X _ _
_ _ X _ X _ X _ X X X X X X X X X X X X _ X _ X _ X _ X _ _
_ _ X _ X _ X _ _ _ _ _ _ _ _ _ _ _ _ _ _ X _ X _ X _ X _ _
_ _ X _ X _ X X X X X X X X X X X X X X X X _ X _ X _ X _ _
_ _ X _ X _ _ _ _ _ _ _ _ _ _ _ _ _ _ _ _ _ _ X _ X _ X _ _
_ _ X _ _ X X X X X X X X X X X X X X X X X X _ _ X _ X _ _
_ _ X _ _ _ _ _ _ _ _ _ _ _ _ _ _ _ _ _ _ _ _ _ _ X _ X _ _
2 2 X X X X X X X X X X X X X X X X X X X X X X X _ _ X _ _
2 2 _ _ _ _ _ _ _ _ _ _ _ _ _ _ _ _ _ _ _ _ _ _ _ _ _ X 0 0
2 2 X X X X X X X X X X X X X X X X X X X X X X X X X 0 0 0
2 2 _ _ _ _ _ _ _ _ _ _ _ _ _ _ _ _ _ _ _ _ _ _ _ _ 0 0 0 0