40 40 
1 1 _ _ _ _ _ _ _ _ E _ _ _ _ _ _ _ _ _ _ _ _ _ _ _ _ _ Q _ _ _ _ _ _ _ _ _ 4 4
1 1 _ _ _ _ _ _ _ _ _ _ _ _ _ _ _ _ _ _ _ _ _ _ _ _ _ _ _ _ _ B _ _ _ _ _ _ 4 4
_ _ _ _ _ _ _ B _ _ _ _ _ _ _ X _ _ X _ _ _ _ _ _ _ _ _ _ _ _ X _ _ _ _ _ _ _ _
_ _ _ _ _ _ _ X _ _ _ _ G X _ _ _ _ _ C _ _ _ _ X G _ _ _ _ _ _ _ _ _ _ _ _ _ _
_ _ _ _ D _ _ X _ _ _ _ _ _ _ _ _ _ _ _ X _ _ _ _ _ _ _ _ _ _ _ _ D _ _ _ _ _ _
1 1 _ _ _ L _ X A _ _ _ _ _ _ _ _ _ _ _ _ _ _ _ _ _ _ _ _ _ _ _ _ _ O X _ _ 4 4
1 1 _ _ _ _ _ 1 X A _ _ _ _ _ _ _ _ _ _ _ _ _ _ _ _ _ _ _ X A _ A X _ X _ _ _ _
_ _ _ X _ _ _ _ _ X _ _ _ _ X X X X X X X X X X X X _ _ _ _ _ _ _ _ _ _ _ _ _ _
_ _ _ _ _ _ _ _ _ _ X _ _ B X 1 1 _ _ _ _ _ _ 4 4 X _ _ _ _ _ _ _ X _ _ _ _ _ _
_ _ _ _ X _ _ _ _ _ B _ _ _ _ _ _ _ _ _ _ _ _ _ _ X _ _ _ _ _ _ _ 4 _ _ _ _ _ _
_ _ _ _ _ _ _ _ _ _ _ _ _ _ X _ _ _ _ _ _ _ _ _ _ X _ _ _ _ _ _ _ _ _ _ _ _ _ _
_ _ _ _ _ _ _ _ _ _ _ _ _ _ X _ _ _ _ F _ _ _ _ _ X _ _ _ _ _ _ _ X _ _ _ _ _ _
1 1 _ _ _ _ _ _ _ X _ _ _ _ X _ _ _ _ _ _ _ _ _ _ X _ _ _ _ _ _ _ _ _ _ _ _ 4 4
1 1 _ _ _ _ _ B _ _ _ _ _ _ X _ _ _ _ _ _ _ _ _ _ _ _ _ _ X G _ _ _ _ X _ _ 4 4
_ _ _ _ _ _ X _ _ _ _ _ _ A X 2 2 _ _ _ _ _ _ 3 3 X B _ _ _ _ _ _ _ _ X _ _ _ _
_ _ _ _ _ X _ _ _ _ _ _ _ _ X X X X X X X X X X X X _ _ _ _ _ _ _ _ X X _ _ _ _
Q _ _ _ X _ _ _ G _ _ _ _ _ _ _ _ _ _ _ _ _ _ _ _ A _ _ _ _ _ _ _ _ B _ _ _ _ E
_ _ _ X B _ _ _ _ _ _ _ _ _ _ _ _ _ _ _ _ _ _ _ _ _ _ _ _ _ H _ _ _ _ _ _ _ _ _
_ _ _ _ X _ _ _ _ _ _ _ _ X X X X X A _ _ X X X X X _ _ _ _ _ _ _ _ _ _ _ _ _ _
_ _ _ _ _ X _ _ _ _ _ _ _ _ _ _ _ X _ I _ X _ _ _ _ _ _ _ _ _ _ _ _ _ _ _ _ _ _
_ _ _ _ _ X _ _ _ _ H _ _ _ _ _ _ X _ _ _ X A _ _ _ _ _ _ _ _ _ _ _ _ _ _ _ _ _
_ _ _ _ _ X _ _ _ _ _ _ _ _ _ _ _ _ _ _ _ _ _ _ _ _ _ _ _ _ _ _ _ _ _ _ _ _ _ _
E _ _ _ _ _ _ _ _ _ _ _ _ _ _ _ _ _ _ _ _ _ _ _ _ _ _ _ _ _ B _ _ _ _ _ _ _ _ _
_ _ _ _ _ _ _ _ _ _ _ _ _ _ _ _ _ _ _ _ _ _ _ _ _ _ _ _ _ _ _ X X X _ _ _ _ _ Q
_ _ _ _ _ B _ _ _ X A _ _ _ _ _ _ _ _ R _ _ _ _ _ _ _ _ _ _ _ X S X _ _ _ _ _ _
_ _ _ _ X _ _ _ _ S X _ _ _ _ _ _ _ _ _ _ _ _ _ _ _ _ _ _ _ A X _ X _ X _ _ _ _
2 2 _ _ _ _ _ _ _ X A _ _ _ _ _ _ _ _ _ _ _ _ _ _ _ _ _ _ _ _ _ _ _ _ X _ _ 3 3
2 2 _ _ _ G _ _ X _ _ _ _ _ _ _ _ _ _ _ _ _ B _ _ _ _ _ _ _ A X _ X _ X _ _ 3 3
_ _ X _ X _ _ _ B _ _ _ _ _ X _ _ X X X X X X _ _ _ _ _ _ _ _ X _ X _ _ _ _ _ _
_ _ _ _ _ _ _ _ _ _ _ _ _ X 2 _ _ _ A _ _ _ _ _ _ _ _ _ _ _ _ X X X B _ _ _ _ _
_ _ _ _ _ _ X _ _ _ _ _ _ _ _ _ _ _ _ _ _ _ 3 X _ _ _ _ _ _ _ _ _ _ _ _ _ _ _ _
_ _ _ _ _ _ _ _ _ H _ _ _ _ X X X X X X _ _ X _ _ _ _ H _ _ _ _ _ _ _ _ _ _ _ _
_ _ _ _ D _ _ _ _ _ _ _ _ _ B _ _ _ _ _ _ _ _ _ _ _ _ _ _ _ _ _ _ D _ X _ _ _ _
_ _ _ _ _ _ _ _ X _ _ X _ _ _ _ _ _ _ _ _ _ _ _ _ _ _ _ _ _ _ X _ _ _ _ _ _ _ _
2 2 _ _ _ M _ _ A B _ _ _ _ _ _ X _ _ _ X _ _ _ X _ _ _ _ _ _ _ _ X N _ _ X 3 3
2 2 _ _ _ X X X X X A _ _ X _ _ X X _ X X _ X _ X A X _ _ _ X _ _ G _ X _ _ 3 3
_ _ _ _ _ _ _ _ X X _ _ _ _ _ _ X T X _ X _ _ _ X X A _ _ E _ X _ _ _ _ _ _ _ _
_ _ _ _ _ _ _ _ _ X _ _ X _ _ _ X _ _ _ X _ X _ X _ X _ _ X X X _ _ _ X _ _ _ _
2 2 X _ _ _ _ _ _ X _ _ _ X _ _ X _ _ _ X _ X _ X _ _ X _ X _ _ _ _ _ _ _ _ X 3
2 2 _ _ _ _ _ _ _ X _ _ _ _ _ _ X _ _ _ Q _ X _ X _ _ G _ _ X _ _ _ _ _ _ _ 3 3