1 1 1 _ _ _ _ _ _ _ _ _ _ B X X X B _ _ _ _ _ _ _ _ _ 4 4 4
1 1 1 X X _ _ _ _ _ _ X X X X S X X X X _ _ _ _ _ X X 4 4 4
1 1 X X _ _ _ _ X X X X _ _ _ _ _ _ _ X X X X _ _ _ X X 4 4
_ X X + _ _ X X X _ X _ _ _ _ _ _ _ _ _ X _ X X X _ + X X _
_ X _ _ L _ _ _ _ _ X _ _ _ _ _ _ _ _ _ X _ _ _ _ O _ _ X _
_ _ _ X _ _ _ _ _ _ X _ _ _ _ X _ _ _ _ X _ _ _ _ _ _ _ _ _
_ _ _ X _ _ _ _ _ _ X _ _ _ _ X _ _ _ _ X _ _ _ _ _ X _ _ _
_ _ X X _ _ _ _ A _ X _ _ _ _ X _ _ _ _ X _ A _ _ _ X X _ _
_ _ X _ _ _ _ _ _ _ _ _ _ _ _ X _ _ _ _ _ _ _ _ _ _ _ X _ _
_ _ X X X X X X _ _ _ _ _ _ _ X _ _ _ _ _ _ X X X X X X _ _
_ X X _ _ _ _ _ _ _ _ _ _ _ _ X _ _ _ _ _ _ _ _ _ _ _ X X _
_ X _ _ _ _ _ _ _ _ _ _ _ _ _ X _ _ _ _ _ _ _ _ _ _ _ _ X _
B X _ _ _ _ _ _ _ _ _ _ _ X _ X _ X _ _ _ _ _ _ _ _ _ _ X B
X X _ _ _ _ _ _ _ _ _ _ _ _ G _ E _ _ _ _ _ _ _ _ _ _ _ X X
X R + _ _ X X X X X X X X X _ I _ X X X X X X X X _ _ + R X
X X _ _ _ _ _ _ _ _ _ _ _ _ E _ G _ _ _ _ _ _ _ _ _ _ _ X X
B X _ _ _ _ _ _ _ _ _ _ _ X _ X _ X _ _ _ _ _ _ _ _ _ _ X B
_ X _ _ _ _ _ _ _ _ _ _ _ _ _ X _ _ _ _ _ _ _ _ _ _ _ _ X _
_ X X _ _ _ _ _ _ _ _ _ _ _ _ X _ _ _ _ _ _ _ _ _ _ _ X X _
_ _ X X X X X X X _ _ _ _ _ _ X _ _ _ _ _ _ X X X X X X _ _
_ _ X _ _ _ _ _ _ _ _ _ _ _ _ X _ _ _ _ _ _ _ _ _ _ _ X _ _
_ _ X X _ _ _ _ A _ X _ _ _ _ X _ _ _ _ X _ A _ _ _ X X _ _
_ _ _ X _ _ _ _ _ _ X _ _ _ _ X _ _ _ _ X _ _ _ _ _ X _ _ _
_ _ _ X _ _ _ _ _ _ X _ _ _ _ X _ _ _ _ X _ _ _ _ _ X _ _ _
_ _ _ _ _ _ _ _ _ _ X _ _ _ _ X _ _ _ _ X _ _ _ _ _ _ _ _ _
_ X _ _ N _ _ _ _ _ X _ _ _ _ _ _ _ _ _ X _ _ _ _ M _ _ X _
_ X X + _ _ X X X _ X _ _ _ _ _ _ _ _ _ X _ X X X _ + X X _
3 3 X X _ _ _ _ X X X X _ _ _ _ _ _ _ X X X X _ _ _ X X 2 2
3 3 3 X X _ _ _ _ _ _ X X X X S X X X X _ _ _ _ _ X X 2 2 2
3 3 3 _ _ _ _ _ _ _ _ _ _ B X X X B _ _ _ _ _ _ _ _ _ 2 2 2