1 1 1 _ X _ _ _ _ _ _ _ _ _ X X _ _ _ _ _ _ _ _ _ X _ 4 4 4
1 L 1 _ X _ _ _ X _ _ _ _ _ + _ _ _ _ _ _ X _ _ _ X _ 4 O 4
1 1 1 _ X _ _ _ X _ _ _ _ _ _ _ _ _ _ _ _ X _ _ _ X _ 4 4 4
_ _ _ _ _ _ _ _ X _ _ _ _ _ _ _ _ _ _ _ _ X _ _ _ _ _ _ _ _
X X X _ + _ _ A X _ _ _ _ _ _ _ _ _ _ _ _ X A _ _ + _ X X X
_ _ _ _ _ _ _ X X _ _ _ _ _ _ _ _ _ _ _ _ X X _ _ _ _ _ _ _
_ _ _ _ _ _ X X _ _ _ _ _ 0 0 0 0 _ _ _ _ _ X X _ _ _ _ _ _
_ _ _ _ A X X B _ _ _ _ _ 0 0 0 0 _ _ _ _ _ B X X A _ _ _ _
_ X X X X X _ _ _ _ _ _ _ 0 0 0 0 _ _ _ _ _ _ _ X X X X X _
_ _ _ _ _ _ _ 0 0 0 0 0 _ _ _ _ _ _ 0 0 0 0 0 _ _ _ _ _ _ _
_ _ _ _ _ _ _ 0 0 0 0 0 _ _ _ _ _ _ 0 0 0 0 0 _ _ _ _ _ _ _
_ _ _ _ _ _ _ 0 0 0 0 0 _ X _ _ X _ 0 0 0 0 0 _ _ _ _ _ _ _
_ _ _ _ _ _ _ _ _ _ _ _ X X _ _ X X _ _ _ _ _ _ _ _ _ _ _ _
_ _ _ _ 0 0 0 _ _ _ _ X X R _ _ S X X _ _ _ _ 0 0 0 _ _ _ _
X _ _ _ 0 0 0 _ _ _ _ _ _ _ _ + _ _ _ _ _ _ _ 0 0 0 _ _ C X
X C _ _ 0 0 0 _ _ _ _ _ _ _ + _ _ _ _ _ _ _ _ 0 0 0 _ _ _ X
_ _ _ _ 0 0 0 _ _ _ _ X X S _ _ R X X _ _ _ _ 0 0 0 _ _ _ _
_ _ _ _ _ _ _ _ _ _ _ _ X X _ _ X X _ _ _ _ _ _ _ _ _ _ _ _
_ _ _ _ _ _ _ 0 0 0 0 0 _ X _ _ X _ 0 0 0 0 0 _ _ _ _ _ _ _
_ _ _ _ _ _ _ 0 0 0 0 0 _ _ _ _ _ _ 0 0 0 0 0 _ _ _ _ _ _ _
_ _ _ _ _ _ _ 0 0 0 0 0 _ _ _ _ _ _ 0 0 0 0 0 _ _ _ _ _ _ _
_ X X X X X _ _ _ _ _ _ _ 0 0 0 0 _ _ _ _ _ _ _ X X X X X _
_ _ _ _ A X X B _ _ _ _ _ 0 0 0 0 _ _ _ _ _ B X X A _ _ _ _
_ _ _ _ _ _ X X _ _ _ _ _ 0 0 0 0 _ _ _ _ _ X X _ _ _ _ _ _
_ _ _ _ _ _ _ X X _ _ _ _ _ _ _ _ _ _ _ _ X X _ _ _ _ _ _ _
X X X _ + _ _ A X _ _ _ _ _ _ _ _ _ _ _ _ X A _ _ + _ X X X
_ _ _ _ _ _ _ _ X _ _ _ _ _ _ _ _ _ _ _ _ X _ _ _ _ _ _ _ _
3 3 3 _ X _ _ _ X _ _ _ _ _ _ _ _ _ _ _ _ X _ _ _ X _ 2 2 2
3 N 3 _ X _ _ _ X _ _ _ _ _ _ + _ _ _ _ _ X _ _ _ X _ 2 M 2
3 3 3 _ X _ _ _ _ _ _ _ _ _ X X _ _ _ _ _ _ _ _ _ X _ 2 2 2