1 1 1 1 X _ _ _ _ _ _ _ _ _ _ _ _ _ _ _ _ _ _ _ G X 4 4 4 4
1 1 1 1 X _ X X X X X X X X X X X X X X X X X X X X 4 4 4 4
1 1 1 1 X _ _ _ _ _ _ _ _ _ _ _ _ _ _ _ _ _ _ _ _ _ 4 4 4 4
1 1 1 1 X _ X X X X X X X X X X X X X X X X X X X X 4 4 4 4
X X _ X X _ X _ _ _ _ _ _ _ _ _ _ _ _ _ _ _ _ _ _ X X X X X
G X _ X _ _ X _ _ _ _ _ _ _ _ _ _ _ _ _ _ _ _ _ _ _ _ _ _ _
_ X _ X _ _ X _ X X X X X X X X X X X X X X X X X X X _ X _
_ X _ X _ _ X _ _ _ _ X 0 0 0 0 0 0 0 X A _ _ _ _ _ X _ X _
_ X _ X _ _ X _ _ _ _ X 0 X X X X 0 0 X _ _ _ X _ _ X _ X _
_ X _ X _ _ X A _ _ _ _ _ _ X X 0 0 0 X _ _ _ X _ _ X _ X _
_ X _ X _ _ X X X X _ _ _ _ _ _ _ _ _ _ _ _ _ X _ _ X _ X _
_ X _ X _ _ X 0 0 0 _ _ _ _ _ _ _ _ _ _ _ X X X _ _ X _ X _
_ X _ X _ _ X 0 0 0 _ _ B X 0 0 X B _ _ _ 0 0 X _ _ X _ X _
_ X _ X _ _ X 0 X 0 _ _ X X 0 0 X X _ _ _ X 0 X _ _ X _ X _
_ X _ X _ _ X 0 X X _ _ 0 0 H H 0 0 _ _ X X 0 X _ _ X _ X _
_ X _ X _ _ X 0 X X _ _ 0 0 H H 0 0 _ _ X X 0 X _ _ X _ X _
_ X _ X _ _ X 0 X _ _ _ X X 0 0 X X _ _ 0 X 0 X _ _ X _ X _
_ X _ X _ _ X 0 0 _ _ _ B X 0 0 X B _ _ 0 0 0 X _ _ X _ X _
_ X _ X _ _ X X X _ _ _ _ _ _ _ _ _ _ _ 0 0 0 X _ _ X _ X _
_ X _ X _ _ X _ _ _ _ _ _ _ _ _ _ _ _ _ X X X X _ _ X _ X _
_ X _ X _ _ X _ _ _ X 0 0 0 X X _ _ _ _ _ _ A X _ _ X _ X _
_ X _ X _ _ X _ _ _ X 0 0 X X X X 0 X _ _ _ _ X _ _ X _ X _
_ X _ X _ _ _ _ _ A X 0 0 0 0 0 0 0 X _ _ _ _ X _ _ X _ X _
_ X _ X X X X X X X X X X X X X X X X X X X _ X _ _ X _ X _
_ _ _ _ _ _ _ _ _ _ _ _ _ _ _ _ _ _ _ _ _ _ _ X _ _ X _ X G
X X X X X _ _ _ _ _ _ _ _ _ _ _ _ _ _ _ _ _ _ X _ X X _ X X
3 3 3 3 X X X X X X X X X X X X X X X X X X X X _ X 2 2 2 2
3 3 3 3 _ _ _ _ _ _ _ _ _ _ _ _ _ _ _ _ _ _ _ _ _ X 2 2 2 2
3 3 3 3 X X X X X X X X X X X X X X X X X X X X _ X 2 2 2 2
3 3 3 3 X G _ _ _ _ _ _ _ _ _ _ _ _ _ _ _ _ _ _ _ X 2 2 2 2