5 5 5 5 _ _ _ _ _ _ _ _ _ _ _ _ _ _ _ _ _ _ _ _ _ _ _ _ 1 1
5 5 5 X X X X X X X X X X X X X X X X X X X X X X X X X 1 1
5 5 X _ _ _ _ _ _ _ _ _ _ _ _ _ _ _ _ _ _ _ _ _ _ _ _ _ 1 1
_ _ X _ _ X X X X X X X X X X X X X X X X X X X X X X _ 1 1
_ _ X _ X _ _ _ _ _ _ _ _ _ _ _ _ _ _ _ _ _ _ _ _ _ _ X _ _
_ _ X _ X _ _ X X X X X X X X X X X X X X X X X X _ _ X _ _
_ _ X _ X _ X _ _ _ _ _ _ _ _ _ _ _ _ _ _ _ _ _ _ X _ X _ _
_ _ X _ X _ X _ X X X X X X X X X X X X X X X X _ X _ X _ _
_ _ X _ X _ X _ X _ _ _ _ _ _ _ _ _ _ _ _ _ _ X _ X _ X _ _
_ _ X _ X _ X _ X _ X X X X X X X X X X X X _ X _ X _ X _ _
_ _ X _ X _ X _ X _ X _ _ _ _ _ _ _ _ _ _ X _ X _ X _ X _ _
_ _ X _ X _ X _ X _ X _ X X X X X X X X _ X _ X _ X _ X _ _
_ _ X _ X _ X _ X _ X 5 5 5 5 5 5 5 5 X _ X _ X _ X _ X _ _
_ _ X _ X _ X _ X _ X 5 5 5 5 5 5 5 5 X _ X _ X _ X _ X _ _
_ _ X _ X _ X _ X _ X 5 5 5 R S 5 5 5 X _ X _ X _ X _ X _ _
_ _ X _ X _ X _ X _ X 5 5 5 S R 5 5 5 X _ X _ X _ X _ X _ _
_ _ X _ X _ X _ X _ X 5 5 5 5 5 5 5 5 X _ X _ X _ X _ X _ _
_ _ X _ X _ X _ X _ X 5 5 5 5 5 5 5 5 X _ X _ X _ X _ X _ _
_ _ X _ X _ X _ X _ X X X X X X X X _ X _ X _ X _ X _ X _ _
_ _ X _ X _ X _ X _ _ _ _ _ _ _ _ _ _ X _ X _ X _ X _ X _ _
_ _ X _ X _ X _ X X X X X X X X X X X X _ X _ X _ X _ X _ _
_ _ X _ X _ X _ _ _ _ _ _ _ _ _ _ _ _ _ _ X _ X _ X _ X _ _
_ _ X _ X _ X X X X X X X X X X X X X X X X _ X _ X _ X _ _
_ _ X _ X _ _ _ _ _ _ _ _ _ _ _ _ _ _ _ _ _ _ X _ X _ X _ _
_ _ X _ _ X X X X X X X X X X X X X X X X X X _ _ X _ X _ _
_ _ X _ _ _ _ _ _ _ _ _ _ _ _ _ _ _ _ _ _ _ _ _ _ X _ X _ _
2 2 X X X X X X X X X X X X X X X X X X X X X X X _ _ X _ _
2 2 _ _ _ _ _ _ _ _ _ _ _ _ _ _ _ _ _ _ _ _ _ _ _ _ _ X 5 5
2 2 X X X X X X X X X X X X X X X X X X X X X X X X X 5 5 5
2 2 _ _ _ _ _ _ _ _ _ _ _ _ _ _ _ _ _ _ _ _ _ _ _ _ 5 5 5 5